Size 10
ENTRY 1 3
EXIT 9 5
1 0 0 1 1 1 0 0 1 1
1 1 0 1 1 1 0 0 1 1
0 0 0 0 1 1 0 0 1 1
0 1 1 0 1 1 0 0 1 1
1 1 1 0 0 0 0 0 1 1
1 0 0 1 1 1 0 0 1 1
1 1 0 1 1 1 0 0 1 1
0 0 0 0 1 1 0 0 1 1
0 1 1 0 1 0 0 0 1 1
1 1 1 1 1 0 1 1 1 1

